{
  "name": "L02_empty_backpack",
  "width": 20,
  "height": 15,
  "tileSize": 32,
  "layers": [
    {
      "name": "floor",
      "data": [
        4,4,4,4,4,4,4,4,4,4,4,4,4,4,4,4,4,4,4,4,
        3,2,2,2,2,2,2,2,2,2,2,2,2,2,2,2,2,2,2,3,
        3,2,2,2,2,2,2,2,2,2,2,2,2,2,2,2,2,2,2,3,
        3,2,2,2,2,2,2,2,2,2,2,2,2,2,2,2,2,2,2,3,
        3,2,2,0,0,0,0,0,2,2,2,2,2,2,2,2,2,2,2,3,
        3,2,2,0,0,0,0,0,2,2,2,2,2,2,2,2,2,2,2,3,
        3,2,2,0,0,0,0,0,2,2,2,2,2,2,2,2,2,2,2,3,
        3,2,2,2,2,2,2,2,2,2,2,2,2,2,2,2,2,2,2,3,
        3,2,2,2,2,2,2,2,2,2,2,2,2,2,2,2,2,2,2,3,
        3,2,2,2,2,2,2,2,2,2,2,2,2,2,2,2,2,2,2,3,
        3,2,2,0,0,0,0,0,2,2,2,2,2,2,2,2,2,2,2,3,
        3,2,2,0,0,0,0,0,2,2,2,2,2,2,2,2,2,2,2,3,
        3,2,2,0,0,0,0,0,2,2,2,2,2,2,2,2,2,2,2,3,
        3,2,2,2,2,2,2,2,2,2,2,2,2,2,2,2,2,2,2,3,
        3,3,3,3,3,3,3,3,3,3,3,3,3,3,3,3,3,3,3,3
      ]
    },
    {
      "name": "collision",
      "data": [
        1,1,1,1,1,1,1,1,1,1,1,1,1,1,1,1,1,1,1,1,
        1,0,0,0,0,0,0,0,0,0,0,0,0,0,0,0,0,0,0,1,
        1,0,0,0,0,0,0,0,0,0,0,0,0,0,0,0,0,0,0,1,
        1,0,0,0,0,0,0,0,0,0,0,0,0,0,0,0,0,0,0,1,
        1,0,0,1,1,1,1,1,0,0,0,0,0,0,0,0,0,0,0,1,
        1,0,0,1,1,1,1,1,0,0,0,0,0,0,0,0,0,0,0,1,
        1,0,0,1,1,1,1,1,0,0,0,0,0,0,0,0,0,0,0,1,
        1,0,0,0,0,0,0,0,0,0,0,0,0,0,0,0,0,0,0,1,
        1,0,0,0,0,0,0,0,0,0,0,0,0,0,0,0,0,0,0,1,
        1,0,0,0,0,0,0,0,0,0,0,0,0,0,0,0,0,0,0,1,
        1,0,0,1,1,1,1,1,0,0,0,0,0,0,0,0,0,0,0,1,
        1,0,0,1,1,1,1,1,0,0,0,0,0,0,0,0,0,0,0,1,
        1,0,0,1,1,1,1,1,0,0,0,0,0,0,0,0,0,0,0,1,
        1,0,0,0,0,0,0,0,0,0,0,0,0,0,0,0,0,0,0,1,
        1,1,1,1,1,1,1,1,1,1,1,1,1,1,1,1,1,1,1,1
      ]
    }
  ],
  "objects": [
    {"type": "spawn", "x": 2, "y": 7},
    {"type": "terminal", "x": 17, "y": 7},
    {"type": "door", "x": 19, "y": 7, "locked": true}
  ],
  "metadata": {
    "concept": "variables",
    "hint": "Declare variables to carry items"
  }
}
