{
  "name": "L04_repeating_strike",
  "width": 20,
  "height": 15,
  "tileSize": 32,
  "layers": [
    {
      "name": "floor",
      "data": [
        4,4,4,4,4,4,4,4,4,4,4,4,4,4,4,4,4,4,4,4,
        3,1,1,1,1,1,1,1,1,1,1,1,1,1,1,1,1,1,1,3,
        3,1,1,1,1,1,1,1,1,1,1,1,1,1,1,1,1,1,1,3,
        3,1,1,1,1,1,1,1,1,1,1,1,1,1,1,1,1,1,1,3,
        3,1,1,1,1,1,1,1,1,1,1,1,1,1,1,1,1,1,1,3,
        3,0,0,0,0,0,0,0,0,0,0,0,0,0,0,0,0,0,0,3,
        3,0,0,0,0,0,0,0,0,0,0,0,0,0,0,0,0,0,0,3,
        3,0,0,0,0,0,0,0,0,0,0,0,0,0,0,0,0,0,0,3,
        3,0,0,0,0,0,0,0,0,0,0,0,0,0,0,0,0,0,0,3,
        3,0,0,0,0,0,0,0,0,0,0,0,0,0,0,0,0,0,0,3,
        3,1,1,1,1,1,1,1,1,1,1,1,1,1,1,1,1,1,1,3,
        3,1,1,1,1,1,1,1,1,1,1,1,1,1,1,1,1,1,1,3,
        3,1,1,1,1,1,1,1,1,1,1,1,1,1,1,1,1,1,1,3,
        3,1,1,1,1,1,1,1,1,1,1,1,1,1,1,1,1,1,1,3,
        3,3,3,3,3,3,3,3,3,3,3,3,3,3,3,3,3,3,3,3
      ]
    },
    {
      "name": "collision",
      "data": [
        1,1,1,1,1,1,1,1,1,1,1,1,1,1,1,1,1,1,1,1,
        1,0,0,0,0,0,0,0,0,0,0,0,0,0,0,0,0,0,0,1,
        1,0,0,0,0,0,0,0,0,0,0,0,0,0,0,0,0,0,0,1,
        1,0,0,0,0,0,0,0,0,0,0,0,0,0,0,0,0,0,0,1,
        1,0,0,0,0,0,0,0,0,0,0,0,0,0,0,0,0,0,0,1,
        1,1,1,1,1,1,1,1,1,1,1,1,1,1,1,1,1,1,1,1,
        1,1,1,1,1,1,1,1,1,1,1,1,1,1,1,1,1,1,1,1,
        1,1,1,1,1,1,1,1,1,1,1,1,1,1,1,1,1,1,1,1,
        1,1,1,1,1,1,1,1,1,1,1,1,1,1,1,1,1,1,1,1,
        1,1,1,1,1,1,1,1,1,1,1,1,1,1,1,1,1,1,1,1,
        1,0,0,0,0,0,0,0,0,0,0,0,0,0,0,0,0,0,0,1,
        1,0,0,0,0,0,0,0,0,0,0,0,0,0,0,0,0,0,0,1,
        1,0,0,0,0,0,0,0,0,0,0,0,0,0,0,0,0,0,0,1,
        1,0,0,0,0,0,0,0,0,0,0,0,0,0,0,0,0,0,0,1,
        1,1,1,1,1,1,1,1,1,1,1,1,1,1,1,1,1,1,1,1
      ]
    }
  ],
  "objects": [
    {"type": "spawn", "x": 2, "y": 2},
    {"type": "terminal", "x": 17, "y": 12},
    {"type": "door", "x": 19, "y": 12, "locked": true}
  ],
  "metadata": {
    "concept": "loops",
    "hint": "Use loops to strike repeatedly"
  }
}
