{
  "id": "L04",
  "title": "The Repeating Strike",
  "concept": "loops",
  "width": 20,
  "height": 15,
  "tiles": [
    [4,4,4,4,4,4,4,4,4,4,4,4,4,4,4,4,4,4,4,4],
    [3,1,1,1,1,1,1,1,1,1,1,1,1,1,1,1,1,1,1,3],
    [3,1,1,1,1,1,1,1,1,1,1,1,1,1,1,1,1,1,1,3],
    [3,1,1,1,1,1,1,1,1,1,1,1,1,1,1,1,1,1,1,3],
    [3,1,1,1,1,1,1,1,1,1,1,1,1,1,1,1,1,1,1,3],
    [3,0,0,0,0,0,0,0,0,0,0,0,0,0,0,0,0,0,0,3],
    [3,0,0,0,0,0,0,0,0,0,0,0,0,0,0,0,0,0,0,3],
    [3,0,0,0,0,0,0,0,0,0,0,0,0,0,0,0,0,0,0,3],
    [3,0,0,0,0,0,0,0,0,0,0,0,0,0,0,0,0,0,0,3],
    [3,0,0,0,0,0,0,0,0,0,0,0,0,0,0,0,0,0,0,3],
    [3,1,1,1,1,1,1,1,1,1,1,1,1,1,1,1,1,1,1,3],
    [3,1,1,1,1,1,1,1,1,1,1,1,1,1,1,1,1,1,1,3],
    [3,1,1,1,1,1,1,1,1,1,1,1,1,1,1,1,1,1,1,3],
    [3,1,1,1,1,1,1,1,1,1,1,1,1,1,1,1,1,1,1,3],
    [3,3,3,3,3,3,3,3,3,3,3,3,3,3,3,3,3,3,3,3]
  ],
  "spawn": {"x": 2, "y": 2},
  "objects": [
    {"type": "terminal", "x": 17, "y": 12},
    {"type": "door", "x": 19, "y": 12, "locked": true}
  ],
  "challenge": {
    "type": "output_count",
    "token": "Strike!",
    "count": 5,
    "hint": "Use a for loop to repeat the strike 5 times.",
    "template": "#include <stdio.h>\n\nint main() {\n    // Use a for loop to print 'Strike!' 5 times\n    \n    return 0;\n}"
  },
  "dialogue": {
    "intro": "The path is long and dangerous. You need to strike repeatedly to clear the way."
  }
}
